Player	Role	Country
Mohammad Nabi	Allrounder	Afghanistan
Mujeeb Ur Rahman	Bowler	Afghanistan
Rashid Khan	Bowler	Afghanistan
A Zampa	Bowler	Australia
AJ Tye	Bowler	Australia
AT Carey	Wicketkeeper batsman	Australia
B Laughlin	Bowler	Australia
B Stanlake	Bowler	Australia
DJM Short	Allrounder	Australia
GJ Maxwell	Allrounder	Australia
JP Faulkner	Allrounder	Australia
NJ Maddinson	Opening batsman	Australia
SA Abbott	Allrounder	Australia
A Symonds	Allrounder	Australia
AB McDonald	Allrounder	Australia
DJ Hussey	Allrounder	Australia
DT Christian	Allrounder	Australia
GB Hogg	Allrounder	Australia
JR Hopes	Allrounder	Australia
MC Henriques	Allrounder	Australia
SPD Smith	Allrounder	Australia
SR Watson	Allrounder	Australia
CA Lynn	Opening batsman	Australia
LA Pomersbach	Opening batsman	Australia
M Klinger	Opening batsman	Australia
SM Katich	Top-order batsman	Australia
TM Head	Middle-order batsman	Australia
B Lee	Bowler	Australia
BCJ Cutting	Bowler	Australia
DE Bollinger	Bowler	Australia
GD McGrath	Bowler	Australia
JL Pattinson	Bowler	Australia
KW Richardson	Bowler	Australia
MA Starc	Bowler	Australia
MG Johnson	Bowler	Australia
NM Coulter-Nile	Bowler	Australia
PJ Cummins	Bowler	Australia
RJ Harris	Bowler	Australia
SK Warne	Bowler	Australia
SW Tait	Bowler	Australia
CJ Ferguson	Middle-order batsman	Australia
CL White	Middle-order batsman	Australia
MEK Hussey	Middle-order batsman	Australia
TR Birt	Middle-order batsman	Australia
AJ Turner	Allrounder	Australia
DA Warner	Opening batsman	Australia
ML Hayden	Opening batsman	Australia
MP Stoinis	Opening batsman	Australia
AC Voges	Top-order batsman	Australia
AJ Finch	Top-order batsman	Australia
BJ Hodge	Top-order batsman	Australia
DR Martyn	Top-order batsman	Australia
GJ Bailey	Top-order batsman	Australia
MR Marsh	Top-order batsman	Australia
PSP Handscomb	Top-order batsman	Australia
RT Ponting	Top-order batsman	Australia
SE Marsh	Top-order batsman	Australia
JR Philippe	Wicketkeeper batsman	Australia
AC Gilchrist	Wicketkeeper batsman	Australia
BJ Haddin	Wicketkeeper batsman	Australia
BR Dunk	Wicketkeeper batsman	Australia
MS Wade	Wicketkeeper batsman	Australia
TD Paine	Wicketkeeper batsman	Australia
Mashrafe Mortaza	Bowler	Bangladesh
Shakib Al Hasan	Allrounder	Bangladesh
Mohammad Ashraful	Middle-order batsman	Bangladesh
Mustafizur Rahman	Bowler	Bangladesh
AD Mascarenhas	Allrounder	England
BA Stokes	Allrounder	England
CJ Jordan	Bowler	England
JC Archer	Bowler	England
JC Buttler	Wicketkeeper batsman	England
JJ Roy	Opening batsman	England
JL Denly	Top-order batsman	England
JM Bairstow	Opening batsman	England
LS Livingstone	Allrounder	England
MM Ali	Allrounder	England
SW Billings	Wicketkeeper batsman	England
TK Curran	Bowler	England
TS Mills	Bowler	England
A Flintoff	Allrounder	England
LJ Wright	Allrounder	England
SM Curran	Allrounder	England
OA Shah	Middle-order batsman	England
CR Woakes	Bowler	England
HF Gurney	Bowler	England
MA Wood	Bowler	England
EJG Morgan	Middle-order batsman	England
RS Bopara	Middle-order batsman	England
T Banton	Opening batsman	England
KP Pietersen	Top-order batsman	England
MJ Lumb	Top-order batsman	England
A Kumble	Bowler	India
AR Patel	Allrounder	India
Avesh Khan	Bowler	India
BB Sran	Bowler	India
GH Vihari	Middle-order batsman	India
Gurkeerat Singh	Middle-order batsman	India
HV Patel	Bowler	India
Ishan Kishan	Wicketkeeper batsman	India
K Gowtham	Allrounder	India
KH Pandya	Allrounder	India
KK Nair	Middle-order batsman	India
KL Rahul	Opening batsman	India
KV Sharma	Bowler	India
Kuldeep Yadav	Bowler	India
MM Sharma	Bowler	India
Mandeep Singh	Allrounder	India
Mohammed Siraj	Bowler	India
P Awana	Bowler	India
P Negi	Bowler	India
Parvez Rasool	Allrounder	India
R Dhawan	Allrounder	India
RA Tripathi	Top-order batsman	India
RD Chahar	Bowler	India
S Kaul	Bowler	India
SC Ganguly	Allrounder	India
SV Samson	Wicketkeeper batsman	India
V Shankar	Allrounder	India
W Jaffer	Opening batsman	India
AM Nayar	Allrounder	India
IK Pathan	Allrounder	India
Joginder Sharma	Allrounder	India
PP Chawla	Allrounder	India
RA Jadeja	Allrounder	India
S Dube	Allrounder	India
STR Binny	Allrounder	India
Shahbaz Ahmed	Allrounder	India
Shivam Mavi	Allrounder	India
YK Pathan	Allrounder	India
CA Pujara	Top-order batsman	India
KM Jadhav	Middle-order batsman	India
M Kaif	Middle-order batsman	India
MA Agarwal	Top-order batsman	India
MK Tiwary	Middle-order batsman	India
RD Gaikwad	Top-order batsman	India
RV Uthappa	Top-order batsman	India
SA Yadav	Middle-order batsman	India
SK Raina	Middle-order batsman	India
SS Tiwary	Middle-order batsman	India
A Mishra	Bowler	India
A Mithun	Bowler	India
A Nehra	Bowler	India
AB Agarkar	Bowler	India
AB Dinda	Bowler	India
Arshdeep Singh	Bowler	India
B Kumar	Bowler	India
CV Varun	Bowler	India
DL Chahar	Bowler	India
DS Kulkarni	Bowler	India
Harbhajan Singh	Bowler	India
I Sharma	Bowler	India
JD Unadkat	Bowler	India
JJ Bumrah	Bowler	India
KK Ahmed	Bowler	India
L Balaji	Bowler	India
M Kartik	Bowler	India
M Markande	Bowler	India
M Prasidh Krishna	Bowler	India
MM Patel	Bowler	India
MS Gony	Bowler	India
Mohammed Shami	Bowler	India
P Kumar	Bowler	India
PP Ojha	Bowler	India
R Ashwin	Bowler	India
R Vinay Kumar	Bowler	India
RP Singh	Bowler	India
RR Powar	Bowler	India
Ravi Bishnoi	Bowler	India
S Nadeem	Bowler	India
S Sreesanth	Bowler	India
Sandeep Sharma	Bowler	India
T Natarajan	Bowler	India
UT Yadav	Bowler	India
VR Aaron	Bowler	India
YS Chahal	Bowler	India
Z Khan	Bowler	India
N Rana	Middle-order batsman	India
S Badrinath	Middle-order batsman	India
V Kohli	Middle-order batsman	India
Washington Sundar	Middle-order batsman	India
Y Venugopal Rao	Middle-order batsman	India
Yuvraj Singh	Middle-order batsman	India
DJ Hooda	Top-order batsman	India
HH Pandya	Allrounder	India
J Yadav	Allrounder	India
SN Thakur	Allrounder	India
SS Iyer	Top-order batsman	India
M Vijay	Opening batsman	India
PP Shaw	Opening batsman	India
Shubman Gill	Opening batsman	India
AM Rahane	Top-order batsman	India
D Padikkal	Top-order batsman	India
G Gambhir	Top-order batsman	India
MK Pandey	Top-order batsman	India
R Dravid	Top-order batsman	India
RG Sharma	Top-order batsman	India
S Dhawan	Top-order batsman	India
SR Tendulkar	Top-order batsman	India
V Sehwag	Top-order batsman	India
VVS Laxman	Top-order batsman	India
WP Saha	Wicketkeeper batsman	India
AT Rayudu	Middle-order batsman	India
KD Karthik	Wicketkeeper batsman	India
MS Dhoni	Wicketkeeper batsman	India
NV Ojha	Wicketkeeper batsman	India
PA Patel	Wicketkeeper batsman	India
RR Pant	Wicketkeeper batsman	India
S Lamichhane	Bowler	Nepal
RN ten Doeschate	Allrounder	Netherlands
C Munro	Allrounder	New Zealand
CJ Anderson	Middle-order batsman	New Zealand
IS Sodhi	Bowler	New Zealand
JDS Neesham	Allrounder	New Zealand
LH Ferguson	Bowler	New Zealand
MJ McClenaghan	Bowler	New Zealand
MJ Santner	Allrounder	New Zealand
TA Boult	Bowler	New Zealand
C de Grandhomme	Allrounder	New Zealand
DL Vettori	Allrounder	New Zealand
JD Ryder	Allrounder	New Zealand
JDP Oram	Allrounder	New Zealand
JEC Franklin	Allrounder	New Zealand
SB Styris	Allrounder	New Zealand
AF Milne	Bowler	New Zealand
DAJ Bracewell	Bowler	New Zealand
NL McCullum	Bowler	New Zealand
SE Bond	Bowler	New Zealand
TG Southee	Bowler	New Zealand
KS Williamson	Middle-order batsman	New Zealand
LRPL Taylor	Middle-order batsman	New Zealand
MJ Guptill	Top-order batsman	New Zealand
SP Fleming	Top-order batsman	New Zealand
BB McCullum	Wicketkeeper batsman	New Zealand
Azhar Mahmood	Allrounder	Pakistan
Shoaib Malik	Allrounder	Pakistan
Shahid Afridi	Allrounder	Pakistan
Mohammad Asif	Bowler	Pakistan
Shoaib Akhtar	Bowler	Pakistan
Umar Gul	Bowler	Pakistan
Younis Khan	Middle-order batsman	Pakistan
Kamran Akmal	Wicketkeeper batsman	Pakistan
A Nortje	Bowler	South Africa
BE Hendricks	Bowler	South Africa
CH Morris	Allrounder	South Africa
D Wiese	Allrounder	South Africa
F Behardien	Allrounder	South Africa
GC Viljoen	Allrounder	South Africa
HH Gibbs	Opening batsman	South Africa
JA Morkel	Allrounder	South Africa
JM Kemp	Allrounder	South Africa
K Rabada	Bowler	South Africa
KJ Abbott	Bowler	South Africa
M Ntini	Bowler	South Africa
Q de Kock	Wicketkeeper batsman	South Africa
SM Pollock	Allrounder	South Africa
T Henderson	Bowler	South Africa
YA Abdulla	Bowler	South Africa
F du Plessis	Top-order batsman	South Africa
J Botha	Allrounder	South Africa
JH Kallis	Allrounder	South Africa
JJ van der Wath	Allrounder	South Africa
R McLaren	Allrounder	South Africa
RE van der Merwe	Allrounder	South Africa
AC Thomas	Bowler	South Africa
CK Langeveldt	Bowler	South Africa
DW Steyn	Bowler	South Africa
Imran Tahir	Bowler	South Africa
J Theron	Bowler	South Africa
M Morkel	Bowler	South Africa
M de Lange	Bowler	South Africa
RJ Peterson	Bowler	South Africa
WD Parnell	Bowler	South Africa
DA Miller	Middle-order batsman	South Africa
JP Duminy	Middle-order batsman	South Africa
GC Smith	Opening batsman	South Africa
CA Ingram	Top-order batsman	South Africa
AB de Villiers	Wicketkeeper batsman	South Africa
H Klaasen	Wicketkeeper batsman	South Africa
MV Boucher	Wicketkeeper batsman	South Africa
DNT Zoysa	Bowler	Sri Lanka
I Udana	Bowler	Sri Lanka
WPUJC Vaas	Bowler	Sri Lanka
A Dananjaya	Allrounder	Sri Lanka
AD Mathews	Allrounder	Sri Lanka
BMAJ Mendis	Allrounder	Sri Lanka
MF Maharoof	Allrounder	Sri Lanka
NLTC Perera	Allrounder	Sri Lanka
SMSM Senanayake	Allrounder	Sri Lanka
ST Jayasuriya	Allrounder	Sri Lanka
TM Dilshan	Allrounder	Sri Lanka
DPMD Jayawardene	Middle-order batsman	Sri Lanka
LPC Silva	Middle-order batsman	Sri Lanka
BAW Mendis	Bowler	Sri Lanka
CRD Fernando	Bowler	Sri Lanka
M Muralitharan	Bowler	Sri Lanka
S Randiv	Bowler	Sri Lanka
SL Malinga	Bowler	Sri Lanka
T Thushara	Bowler	Sri Lanka
KC Sangakkara	Wicketkeeper batsman	Sri Lanka
AD Nath	Middle-order batsman	Uncapped
AR Bawne	Middle-order batsman	Uncapped
AS Rajpoot	Bowler	Uncapped
Anureet Singh	Bowler	Uncapped
Basil Thampi	Bowler	Uncapped
DJ Harris	Middle-order batsman	Uncapped
IC Pandey	Bowler	Uncapped
Karanveer Singh	Allrounder	Uncapped
M Vohra	Middle-order batsman	Uncapped
P Sahu	Bowler	Uncapped
PV Tambe	Bowler	Uncapped
R Shukla	Bowler	Uncapped
R Tewatia	Allrounder	Uncapped
Sachin Baby	Allrounder	Uncapped
Shivam Sharma	Bowler	Uncapped
VH Zol	Middle-order batsman	Uncapped
YV Takawale	Middle-order batsman	Uncapped
Iqbal Abdulla	Allrounder	Uncapped
LR Shukla	Allrounder	Uncapped
M Manhas	Allrounder	Uncapped
MK Lomror	Allrounder	Uncapped
R Bhatia	Allrounder	Uncapped
R Sathish	Allrounder	Uncapped
AC Blizzard	Middle-order batsman	Uncapped
Abdul Samad	Middle-order batsman	Uncapped
IR Jaggi	Middle-order batsman	Uncapped
A Ashish Reddy	Bowler	Uncapped
A Choudhary	Bowler	Uncapped
AN Ahmed	Bowler	Uncapped
Abhishek Sharma	Bowler	Uncapped
Ankit Sharma	Bowler	Uncapped
Harpreet Brar	Bowler	Uncapped
KL Nagarkoti	Bowler	Uncapped
Kartik Tyagi	Bowler	Uncapped
NJ Rimmington	Bowler	Uncapped
P Dubey	Bowler	Uncapped
P Ray Barman	Bowler	Uncapped
PJ Sangwan	Bowler	Uncapped
R Sharma	Bowler	Uncapped
Rasikh Salam	Bowler	Uncapped
S Kaushik	Bowler	Uncapped
S Ladda	Bowler	Uncapped
SB Jakati	Bowler	Uncapped
Swapnil Singh	Bowler	Uncapped
TU Deshpande	Bowler	Uncapped
VS Malik	Bowler	Uncapped
Y Prithvi Raj	Bowler	Uncapped
RK Singh	Middle-order batsman	Uncapped
SD Lad	Middle-order batsman	Uncapped
DJ Muthuswami	Allrounder	Uncapped
J Suchith	Allrounder	Uncapped
KC Cariappa	Bowler	Uncapped
M Ashwin	Bowler	Uncapped
RG More	Bowler	Uncapped
S Gopal	Allrounder	Uncapped
SN Khan	Middle-order batsman	Uncapped
N Jagadeesan	Opening batsman	Uncapped
P Chopra	Opening batsman	Uncapped
YBK Jaiswal	Opening batsman	Uncapped
DR Shorey	Top-order batsman	Uncapped
PK Garg	Top-order batsman	Uncapped
R Parag	Top-order batsman	Uncapped
RK Bhui	Top-order batsman	Uncapped
S Anirudha	Top-order batsman	Uncapped
UBT Chand	Top-order batsman	Uncapped
AP Tare	Wicketkeeper batsman	Uncapped
CM Gautam	Wicketkeeper batsman	Uncapped
DH Yagnik	Wicketkeeper batsman	Uncapped
MS Bisla	Wicketkeeper batsman	Uncapped
DJ Jacobs	Wicketkeeper batsman	Uncapped
NS Naik	Wicketkeeper batsman	Uncapped
P Simran Singh	Wicketkeeper batsman	Uncapped
SP Goswami	Wicketkeeper batsman	Uncapped
AD Russell	Allrounder	West Indies
CR Brathwaite	Allrounder	West Indies
DM Bravo	Allrounder	West Indies
DR Smith	Top-order batsman	West Indies
E Lewis	Opening batsman	West Indies
JO Holder	Allrounder	West Indies
KAJ Roach	Bowler	West Indies
N Pooran	Middle-order batsman	West Indies
R Rampaul	Bowler	West Indies
SP Narine	Allrounder	West Indies
SS Cottrell	Bowler	West Indies
CH Gayle	Allrounder	West Indies
DJ Bravo	Allrounder	West Indies
DJG Sammy	Allrounder	West Indies
KA Pollard	Allrounder	West Indies
KMA Paul	Allrounder	West Indies
MN Samuels	Middle-order batsman	West Indies
RR Sarwan	Middle-order batsman	West Indies
S Chanderpaul	Middle-order batsman	West Indies
FH Edwards	Bowler	West Indies
JE Taylor	Bowler	West Indies
S Badree	Bowler	West Indies
SE Rutherford	Top-order batsman	West Indies
SO Hetmyer	Top-order batsman	West Indies
T Taibu	Wicketkeeper batsman	Zimbabwe
